------------------------------
|............................|
|............................|
|............................|
|............................|
|............................|
|............................|
|...........P................|
|............................|
|............................|
|............................|
|XXXXXXXXXXXX................|
|...........XXXXXXXXXXXXXXXX.|
|......................X.....|
|......................XXX.XX|
|............................|
|............................|
|............................|
|............................|
|............................|
|............................|
|............................|
|............................|
|............................|
|............................|
|......G.....................|
|............................|
|............................|
|............................|
------------------------------
------------------------------
|............................|
|............................|
|............................|
|............................|
|............................|
|............................|
|........X...................|
|........X...................|
|........X...................|
|........X...................|
|........X...................|
|........XXXXXX..............|
|...............XXXX.........|
|..XXXXXXXXX....X..X.........|
|..X.......X.G..X..X.........|
|..X..XXXX.X....X..X.........|
|..X.....X.XXXXXX..X.........|
|..X...P.X.........X.........|
|..XXXXXXX.........X.........|
|..................X.........|
|............................|
|............................|
|............................|
|............................|
|............................|
|............................|
|............................|
|............................|
------------------------------
------------------------------
|...X......................XP|
|.X.X......................X.|
|.X.X......................X.|
|.X.X......................X.|
|.X.X......................X.|
|.X.X......................X.|
|.X.X......................X.|
|.X.X......................X.|
|.X.X......................X.|
|.X.X......................X.|
|.X.X......................X.|
|.X.X......................X.|
|.X.X......................X.|
|.X.XXXXXXXXXXXXXXXXXXXXXXXX.|
|.X..........................|
|.XXXXXXXXXXXXXXXXXXXXXXXXXX.|
|.X..........................|
|.X..........................|
|.X..........................|
|.X..........................|
|.X..........................|
|.X..........................|
|.X..........................|
|.X..........................|
|.X..........................|
|.X..........................|
|.X..........................|
|GX..........................|
------------------------------
------------------------------
|.X.X......................XP|
|.X.X......................X.|
|.X.X......................X.|
|.X.X......................X.|
|.X.X......................X.|
|.X.X......................X.|
|.X.X......................X.|
|.X.X......................X.|
|.X.X......................X.|
|.X.X......................X.|
|.X.X......................X.|
|.X.X......................X.|
|.X.X......................X.|
|.X.XXXXXXXXXXXXXXXXXXXXXXXX.|
|.X..........................|
|.XXXXXXXXXXXXXXXXXXXXXXXXXX.|
|.X..........................|
|.X..........................|
|.X..........................|
|.X..........................|
|.X..........................|
|.X..........................|
|.X..........................|
|.X..........................|
|.X..........................|
|.X..........................|
|.X..........................|
|GX..........................|
------------------------------
